VendorID,InvoiceDate,DueDate,Amount($),Balance
#011,2023-11-01,2023-11-04,150000,150000
#012,2023-11-03,2023-11-07,95000,245000
#013,2023-11-04,2023-11-08,208000,453000
#014,2023-11-05,2023-11-07,985580,1438580
#015,2023-11-07,2023-11-10,150000,1588580
#016,2023-11-13,2023-11-17,95499,1684079
#017,2023-11-15,2023-11-18,299999,1984078
#018,2023-11-26,2023-11-30,99000,2083078

